PXXXXXXXXXXXXXX
XXXXXXXMMMMXXXX
XXXXXXXMMMMXXXX
MXXXXXXMMMMXXXX
MMXXXXXMMMMXXXX
MMXXXXXXXXXXXXX
MXXXXXXXXMXXXXX
MMXXXXXXXMMMXXX
MMXXXXXXMXMMXXX
MXXXXXXXMXMMXXX
MMXXXXXXMMMMXXX
MXXXXXXXMMMMXXX
MXXXXXXXXXXXXXX
MMXXXXXXMXXMXXX
MXXXXXXXXMMXXXG