PXXXXXXXXXXXXXX
XXXXXXXMMMMXXXX
XXXXXXXMXXMXXXX
MXXXXXXMXXMXXXX
MMXXXXXMMMMXXXX
MMXXXXXXXXXXXXX
MXXXXXXXXMXXXXX
XMXXXXXXXMMMXXX
MMXXXXXXMXMMXXX
MXXXXXXXMXMMXXX
XMXXXXXXMMMMXXX
MXXXXXXXMMMMXXX
MXXXXXXXXXXXXXX
MMXXXXXXMXXMXXX
MXXXXXXXXMMXXXG