PXXXXXXXXXXXXXX
XXXXXXXMMMMXXXX
XXXXXXXMMMMXXXX
MXXXXXXMMMMXXXX
MMXXXXXMMMMXXXX
MMXXXXXXXXXXXXX
MXXXXXXXXMXXXXX
MMXXXXXXXMMMXXX
MMXXXXXXMMMMXXX
MXXXXXXXMMMMXXX
MMXXXXXXMMMMXXX
MXXXXXXXMMMMXXX
MXXXXXXXXXXXXXX
MMXXXXXXMXXMXXX
MXXXXXXXXMMXXXG